trimmed-Asgard_WA_C_LAR	Cascade
trimmed-Billy-Goat_WA_C_LAR	Cascade
trimmed-Carne_WA_C_LAR	Cascade
trimmed-Cutthroat_WA_C_LAR	Cascade
trimmed-Harts_WA_C_LAR	Cascade
trimmed-Methow_WA_C_LAR	Cascade
trimmed-Bugaboo_BC_I_LAR	North_Rockies
trimmed-Frozen-Lk_BC_I_LAR	North_Rockies
trimmed-Kokanee_BC_I_LAR	North_Rockies
trimmed-Leigh-Lake-Cabinets_MT_I_LAR	North_Rockies
trimmed-NW-Peak_MT_I_LAR	North_Rockies
trimmed-Purcell_BC_I_LAR	North_Rockies
trimmed-Roman-Nose_ID_I_LAR	North_Rockies
trimmed-Ten-Lakes_MT_I_LAR	North_Rockies
trimmed-Top-of-World_BC_I_LAR	North_Rockies
trimmed-Bob_MT_I_LAR	South_Rockies
trimmed-Carlton_MT_I_LAR	South_Rockies
trimmed-Fuse-Lk_MT_I_LAR	South_Rockies
trimmed-Grave-Pk_ID_I_LAR	South_Rockies
trimmed-Lolo_MT_I_LAR	South_Rockies
trimmed-Losthorse_MT_I_LAR	South_Rockies
trimmed-Mission-Mts_MT_I_LAR	South_Rockies
trimmed-Pintler_MT_I_LAR	South_Rockies
trimmed-Salmon-Mtn_ID_I_LAR	South_Rockies
trimmed-St-Joseph_MT_I_LAR	South_Rockies
trimmed-St-Mary_MT_I_LAR	South_Rockies
trimmed-Swan_MT_I_LAR	South_Rockies
trimmed-Trapper_MT_I_LAR	South_Rockies
